1111111111111111111111
11111P000CC1CCC0000001
1000000100CC0000000001
1C00111111111000000111
11C100111111100001CE01
100000000000000001C011
1111111111111111111111