111111111
1P0C0E0C1
111111111
