1111111111111
1P0C00E000001
1111111111111
