11111111111111111111111111111
11111P000CC000000000000000001
1110001111111000010E000011111
11111111111111111111111111111