1111111111111
1001000000001
10000100P0001
1P0C010000001
1111111111111
